La_Cigale_et_la_Fourmi	non
L’Âne_vêtu_de_la_peau_du_Lion	non
Le_Renard_et_le_Buste	non
Le_Lion_devenu_vieux	non
Le_Vieillard_et_l’Âne	oui
La_Vieille_et_les_deux_Servantes	oui
La_Fille	oui
Le_Faucon_et_le_Chapon	non
Tircis_et_Amarante	oui
Le_Cochet,_le_Chat_et_le_Souriceau	oui
La_Femme_noyée	oui
La_Mort_et_le_Bûcheron	oui
La_Discorde	non
L’Enfant_et_le_Maître_d’école	oui
L’Astrologue_qui_se_laisse	oui
Le_Jardinier_et_son_Seigneur	oui
Le_Renard,_le_Singe,_et_les_Animaux	non
Le_Lion_abattu_par_l’homme	non
La_Montagne_qui_accouche	non
La_jeune_Veuve	oui
Le_Héron	non
La_Mouche_et_la_Fourmi	non
Le_Torrent_et_la_Rivière	non
Les_Obsèques_de_la_Lionne	non
Jupiter_et_le_Métayer	oui
La_Génisse,_la_Chèvre,_et_la_Brebis_en	non
Tribut_envoyé_par_les	non
La_Chauve-souris_et_les_deux_Belettes	non
Le_Rat_et_l’Huître	non
Le_Laboureur_et_ses_Enfants	oui
L’Âne_chargé_d’éponges	oui
Le_Pouvoir_des_Fables	oui
Les_Loups_et_les_Brebis	non
L’Homme_qui_court_après_la_Fortune_et	oui
Le_mal_Marié	oui