Le_Lièvre_et_les_Grenouilles	non
Le_Meunier,_son_Fils,_et_l’Âne	oui
Le_Serpent_et_la_Lime	non
L’éducation	oui
Le_Chartier_embourbé	oui
L’Âne_et_le_petit_Chien	oui
Le_Lion_et_le_Moucheron	non
Le_Berger_et_la_Mer	oui
Le_Chat,_la_Belette,_et_le_petit_Lapin	non
L’Avare_qui_a_perdu_son_trésor	oui
Le_Lion_malade_et_le_Renard	non
L’Homme_et_l’Idole_de_bois	oui
Le_Coche_et_la_Mouche	oui
Le_Paon_se_plaignant_à_Junon	oui
Le_Renard_et_la_Cigogne	non
Le_Cerf_et_la_Vigne	non
Le_Satyre_et_le_Passant	oui
Le_Lion_et_l’Âne_chassant	non
Le_Chêne_et_le_Roseau	non
L’Âne_portant_des_reliques	oui
Le_Singe_et_le_Dauphin	non
Le_Loup_devenu_Berger	non
Les_Devineresses	oui
La_Mort_et_le_Malheureux	oui
L’Âne_et_le_Chien	non
Le_Cerf_se_voyant_dans_l’eau	non
Philomèle_et_Progné	non
Le_Dragon_à_plusieurs_têtes_et_le_Dragon	non
L’Ivrogne_et_sa_Femme	oui
Parole_de_Socrate	oui
Phébus_et_Borée	oui
Le_Cochon,_la_Chèvre_et_le_Mouton	non
L’avantage_de_la_science	oui
L’Horoscope	oui
L’Homme_et_son_Image	oui
L’Alouette_et_ses_Petits	non
Le_Coq_et_la_Perle	non
Les_deux_Chiens_et_l’Âne_mort	non
Le_Renard_et_les_Raisins	non
Le_Loup_et_le_Chien	non
Les_deux_Coqs	non
Le_Villageois_et_le_Serpent	oui
Le_Cheval_et_le_Loup	non
Le_Loup,_la_Mère_et_l’Enfant	oui
L’oiseleur,_l’Autour_et_l’Alouette	oui
La_Besace	non
Le_Rat_qui_s’est_retiré_du_monde	non
La_Lice_et_sa_compagne	non
Le_Lion_et_le_Rat	non
Le_Bassa_et_le_Marchand	oui
Le_Chameau_et_les_Bâtons_flottants	non
Simonide_préservé_par_les_Dieux	oui
Le_Cheval_s’étant_voulu_venger_du_Cerf	oui
Les_Animaux_malades_de_la_peste	non
Le_petit_Poisson_et_le_Pêcheur	oui
Le_Chien_qui_lâche_sa_proie_pour_l’ombre	non
La_Belette_entrée_dans_un_grenier	non
Un_Animal_dans_la_Lune	non
Le_Loup_plaidant_contre_le	non
Le_Curé_et_le_Mort	oui
Le_Loup,_la_Chèvre_et_le_Chevreau	non
L’Oeil_du_Maître	oui
Le_Renard_et_le_Bouc	non
L’Homme_et_la_Puce	oui
Les_Vautours_et_les_Pigeons	non
La_Grenouille_et_le_Rat	non
Le_Savetier_et_le_Financier	oui
Conseil_tenu_par_les_Rats	non
L’Aigle,_la_Laie,_et_la_Chatte	non
L’ingratitude_et_l’injustice_des_Hommes	oui
Les_Médecins	oui
Démocrite_et_les_Abdéritains	oui
Le_Lièvre_et_la_Perdrix	non
Le_Pot_de_terre_et_le_Pot_de_fer	non
La_Grenouille_qui_veut_se_faire_aussi	non
La_Bûcheron_et_Mercure	oui
Le_Rat_de_ville_et_le_Rat_des_champs	non
L’Aigle_et_l’Escarbot	non
Le_Coq_et_le_Renard	non
Le_Lièvre_et_la_Tortue	non
Le_Chat_et_un_vieux_Rat	non
Les_voleurs_et_l’Âne	oui
Testament_expliqué_par_Ésope	oui
Le_Pâtre_et_le_Lion	oui
Le_Loup_et_la_Cigogne	non
Le_Mulet_se_vantant_de_sa_généalogie	non
Le_Lion,_le_Loup,_et_le_Renard	non
Le_Geai_paré_des_plumes_du_Paon	non
Les_deux_Mulets	non
L’Âne_et_ses_Maîtres	oui
Le_Vieillard_et_ses_Enfants	oui
Épilogue	non
Les_deux_Amis	oui
Le_Lion_et_le_Chasseur	oui
L’Oracle_et_l’Impie	oui
﻿Le_Corbeau_et_le_Renard	non
Le_Lièvre_et_les_Grenouilles_	non
La_Grenouille_qui_veut_se_faire_aussi	non
L’Aigle_et_le_Hibou	non
La_Goutte_et_l’Araignée	non
Le_Rat_et_l’Éléphant	non
Le_Cygne_et_le_Cuisinier	oui
Contre_ceux_qui_ont_le_goût_difficile	oui
Les_Frelons_et_les_Mouches_à_miel	non
Le_Cheval_et_l’Âne	non
Le_Renard_ayant_la_queue_coupée	non
Le_Soleil_et_les_Grenouilles	non
Le_Loup_et_le_Chasseur	oui
Le_Chien_qui_porte_à_son_cou_le	non
Le_Lion_s’en_allant_en_guerre	non
La_Laitière_et_le_Pot_au_lait	non
Le_Chat_et_le_Rat	non
Le_Lion_amoureux	oui
L’Ours_et_l’Amateur_des_jardins	oui
La_Poule_aux_œufs_d’or	oui
La_Fortune_et_le_jeune_Enfant	oui
Les_Femmes_et_le_Secret	oui
Les_oreilles_du_Lièvre	non
Le_Combat_des_Rats_et_des_Belettes	non
L’Homme_entre_deux_âges_et_ses	oui
Les_Grenouilles_qui_demandent_un_Roi	non
Le_Charlatan	oui
La_Chatte_métamorphosée_en_Femme	oui
L’Hirondelle_et_les_petits_Oiseaux	non
L’Ours_et_les_deux_compagnons	oui
Les_deux_Taureaux_et_une_Grenouille	non
La_Mort_et_le_Mourant	oui
La_cour_du_Lion	non
La_Tête_et_la_Queue_du_Serpent	non
Les_Souhaits	oui
La_Colombe_et_la_Fourmi	non
La_Grenouille_qui_veut_se_faire_aussi_grosse_que_le_boeuf	non
À_Madame_de_Montespan	oui
Le_Rieur_et_les_Poissons	oui
Le_Loup_et_l’Agneau	non
L’Oiseau_blessé_d’une_flèche	non
Le_Corbeau_voulant_imiter_l’Aigle	non
Jupiter_et_les_tonnerres	non
Les_Membres_et_l’Estomac	oui
